i'm=i am
you're=you are
he's=he is
she's=she is
it's=it is
we're=we are
they're=they are
i've=i have
you've=you have
we've=we have
they've=they have
who's=who is
what's=what is
where's=where is
there's=there is
how's=how is
i'll=i will
you'll=you will
he'll=he will
she'll=she will
it'll=it will
we'll=we will
they'll=they will
isn't=is not
aren't=are not
wasn't=was not
weren't=were not
haven't=have not
hasn't=has not
hadn't=had not
won't=will not
wouldn't=would not
don't=do not
doesn't=does not
didn't=did not
can't=cannot
couldn't=could not
shouldn't=should not
mightn't=might not
mustn't=must not
you'd=you would
he'd=he would
she'd=she would
we'd=we would
they'd=they would
i'd=i would
that's=that is
who'd=who would
who'll=who will
who've=who have
what'll=what will
where'd=where did
where'll=where will
where've=where have
when's=when is
when'll=when will
when've=when have
why's=why is
why'd=why did
why'll=why will
ain't=am not
let's=let us
y'all=you all
ma'am=madam
o'clock=of the clock
ne'er=never
o'er=over
ol'=old
it'd=it would
it've=it have
there'd=there would
there'll=there will
that'd=that would
that'll=that will
who're=who are
what're=what are
what've=what have
where're=where are
when're=when are
why're=why are
how'd=how did
how'll=how will
how've=how have
'tis=it is
'twas=it was
'twere=it were
d'ye=do you
e'er=ever
'gainst=against
'round=around
'bout=about
'cause=because
'til=until
'tween=between
shan't=shall not
daren't=dare not
needn't=need not
oughtn't=ought not
mightn't've=might not have
mustn't've=must not have
couldn't've=could not have
wouldn't've=would not have
shouldn't've=should not have
he'd've=he would have
she'd've=she would have
it'd've=it would have
we'd've=we would have
they'd've=they would have
i'd've=i would have
you'd've=you would have
who'd've=who would have
what'd=what did
what'd've=what would have
where'd've=where would have
when'd=when did
when'd've=when would have
why'd've=why would have
how'd've=how would have
there'd've=there would have
here's=here is
somebody's=somebody is
nobody's=nobody is
somebody'd=somebody would
somebody'll=somebody will
nobody'll=nobody will
someone's=someone is
someone'd=someone would
someone'll=someone will
everyone's=everyone is
no one's=no one is
he'll've=he will have
she'll've=she will have
it'll've=it will have
we'll've=we will have
they'll've=they will have
i'll've=i will have
you'll've=you will have
'twould=it would
'twouldn't=it would not
'tweren't=it were not
g'day=good day
cat's=cat is
dog's=dog is
'sup=what is up
'em=them
fo'c'sle=forecastle
